6 0
0 5 8 7 0 3
5 0 4 0 0 0 
8 4 0 5 0 9
7 0 5 0 5 0
0 0 0 5 0 1
3 0 9 0 1 0